............................................................
............................................................
............................................................
............................................................
............................................................
...........................11...............................
.........................1....1.............................
................................1...........................
........................1.......1...........................
..........11....11..........................................
..........11....11.............111..........................
........... ...................111..........................
...............................111..........................
.......1.....P......1..........111..........................
........111111111111...........111..........................
...............................111..........................
...............................111..........................
............................111111111.......................
............................111111111.......................
............................111111111.......................
............................................................
111111111111111111111111111111111111111111111111100011111111
