.....................................................................................................................................................................................
.....................................................................................................................................................................................
.....................................................................................................................................................................................
.....................................................................................................................................................................................
..........................................................111111111111111111111111...................................................................................................
.....................................................................................................................................................................................
.....................................................................................................................................................................................
...................................................................................................................1111111111111111111...............................................
.....................................................................................................................................................................................
.....................................................................................................................................................................................
.....................................................................................................................................................................................
......................................S..............................................................................................................................................
...........................1111111111111111111111111.................................................................................................................................
.....................................................1..........................................11111111111111111111111111111111111111...............................................
.......................................................1.............................................................................................................................
.........................................................1...........................................................................................................................
...........................................................1.........................................................................................................................
.............................................................1.......................................................................................................................
...............................................................1.....................................................................................................................
.............................................................................1111111111111111111.....................................................................................
.....................................................................................................................................................................................
.....................................................................................................................................................................................
..........................................................................K..........................................................................................................
........................................................1111111111111111111111111111111111111111.....................................................................................
........................................................1............................................................................................................................
........................................................1............................................................................................................................
........................................................1............................................................................................................................
................1........................P..............1............................................................................................................................
.111111111111111111111111111111111111111111111111111111111111111111111111111111111111111111111111111111111111111111111111111111111111111111111111111111111111111111111111111111111111
